"Rank","Nation","Gold","Silver","Bronze","Total"
"1","Morocco","6","10","5","21"
"2","Egypt","4","2","0","6"
"3","Syria","3","2","6","11"
"4","Bahrain","3","2","3","8"
"5","Iraq","2","3","1","6"
"6","Tunisia","2","2","3","7"
"7","Sudan","2","1","1","4"
"8","Algeria","1","2","4","7"
"9","Jordan","0","0","1","1"
"10","Kuwait","0","0","0","0"
"10","Lebanon","0","0","0","0"
"10","Qatar","0","0","0","0"
"Total","23","24","24","71"

